1.多主题模板的前端实现
2.权限检测需要重构不可以用die

Backend
OK 系统管理系统配置网站配置Admin::Index::websiteSet
OK 系统管理系统配置系统配置Admin::Index::systemSet
OK 系统管理系统配置数据库配置Admin::Index::databaseSet
OK 系统管理系统配置修改密码Admin::Index::editMyPass
OK 系统管理系统配置清空缓存Admin::Index::cleanCache
OK 系统管理系统配置清除日志Admin::Index::cleanLog
系统管理管理上传文件管理Admin::ManageUpload::index
系统管理管理上传删除文件Admin::ManageUpload::del
系统管理管理上传清除未用Admin::ManageUpload::edit
OK 系统管理模板管理模板设置Admin::Template::index
OK 系统管理模板管理添加模板Admin::Template::add
OK 系统管理模板管理删除模板Admin::Template::del
OK 系统管理模板管理添加模板Admin::Template::edit
OK 成员管理管理员管理员配置Admin::Admin::setting
OK 成员管理管理员管理员管理Admin::Admin::index
OK 成员管理管理员添加管理员Admin::Admin::add
OK 成员管理管理员删除管理员Admin::Admin::del
OK 成员管理管理员编辑管理员Admin::Admin::edit
OK 成员管理管理员管理组管理Admin::AdminGroup::index
OK 成员管理管理员添加管理组Admin::AdminGroup::add
OK 成员管理管理员删除管理组Admin::AdminGroup::del
OK 成员管理管理员编辑管理组Admin::AdminGroup::edit
OK 成员管理管理员查看管理日志Admin::AdminLog::index
OK 成员管理管理员删除管理日志Admin::AdminLog::del
OK 成员管理会员管理会员配置Admin::Member::setting
OK 成员管理会员管理会员管理Admin::Member::index
OK 成员管理会员管理添加会员Admin::Member::add
OK 成员管理会员管理删除会员Admin::Member::del
OK 成员管理会员管理编辑会员Admin::Member::edit
OK 成员管理会员管理会员组管理Admin::MemberGroup::index
OK 成员管理会员管理添加会员组Admin::MemberGroup::add
OK 成员管理会员管理删除会员组Admin::MemberGroup::del
OK 成员管理会员管理编辑会员组Admin::MemberGroup::edit
OK 内容管理文章文章配置Admin::Article::setting
内容管理文章文章管理Admin::Article::index
内容管理文章添加文章Admin::Article::add
内容管理文章删除文章Admin::Article::del
内容管理文章编辑文章Admin::Article::edit
内容管理文章文章分类Admin::ArticleCategory::index
内容管理文章添加分类Admin::ArticleCategory::add
内容管理文章删除分类Admin::ArticleCategory::del
内容管理文章编辑分类Admin::ArticleCategory::edit
内容管理文章文章频道Admin::ArticleChannel::index
内容管理文章添加频道Admin::ArticleChannel::add
内容管理文章删除频道Admin::ArticleChannel::del
内容管理文章编辑频道Admin::ArticleChannel::edit
内容管理图文链接图文管理Admin::Itlink::index
内容管理图文链接添加图文Admin::Itlink::add
内容管理图文链接删除图文Admin::Itlink::del
内容管理图文链接编辑图文Admin::Itlink::edit
内容管理导航导航管理Admin::Navigation::index
内容管理导航添加导航Admin::Navigation::add
内容管理导航删除导航Admin::Navigation::del
内容管理导航编辑导航Admin::Navigation::edit
扩展管理微信微信管理Admin::Wechat::index
扩展管理微信配置微信Admin::Wechat::add
扩展管理微信删除微信绑定Admin::Wechat::del
扩展管理微信推送消息Admin::Wechat::edit
扩展管理留言板留言板管理Admin::MessageBoard::index
扩展管理留言板添加留言板Admin::MessageBoard::add
扩展管理留言板删除留言板Admin::MessageBoard::del
扩展管理留言板编辑留言板Admin::MessageBoard::edit
扩展管理留言板留言管理Admin::MessageBoardLog::index
扩展管理留言板删除留言Admin::MessageBoardLog::del
扩展管理留言板审核回复Admin::MessageBoardLog::edit
扩展管理评论评论管理Admin::Comment::index
扩展管理评论审核评论Admin::Comment::add
扩展管理评论删除评论Admin::Comment::del
扩展管理评论回复评论Admin::Comment::edit
扩展管理招聘招聘管理Admin::Recruit::index
扩展管理招聘新增招聘Admin::Recruit::add
扩展管理招聘删除招聘Admin::Recruit::del
扩展管理招聘编辑招聘Admin::Recruit::edit
扩展管理招聘应聘记录Admin::RecruitLog::index
扩展管理招聘删除招聘Admin::RecruitLog::del
扩展管理站内信站内信管理Admin::Message::index
扩展管理站内信发送站内信Admin::Message::add
扩展管理站内信删除站内信Admin::Message::del
扩展管理考核考核管理Admin::Assess::index
扩展管理考核新增考核Admin::Assess::add
扩展管理考核删除考核Admin::Assess::del
扩展管理考核编辑考核Admin::Assess::edit
扩展管理考核统计记录Admin::AssessLog::edit
扩展管理考核删除记录Admin::AssessLog::del
扩展管理问卷问卷管理Admin::Quests::index
扩展管理问卷新增问卷Admin::Quests::add
扩展管理问卷删除问卷Admin::Quests::del
扩展管理问卷编辑问卷Admin::Quests::edit
扩展管理问卷答案管理Admin::QuestsAnswer::index
扩展管理问卷清空答案Admin::QuestsAnswer::del
扩展管理问卷统计问卷Admin::QuestsAnswer::edit
扩展管理地域地域管理Admin::Region::index
扩展管理地域新增地域Admin::Region::add
扩展管理地域删除地域Admin::Region::del
扩展管理地域编辑地域Admin::Region::edit


Frontend
成员管理会员管理会员中心Home::Member::index
成员管理会员管理编辑会员Home::Member::edit
扩展管理留言板留言板Home::MessageBoard::index
扩展管理招聘招聘列表Home::Recruit::index
扩展管理招聘应聘职位Home::Recruit::add
扩展管理招聘查看招聘Home::Recruit::edit
扩展管理站内信站内信管理Home::Message::index
扩展管理站内信发送站内信Home::Message::add
扩展管理站内信删除站内信Home::Message::del
扩展管理考核考核管理Home::Assess::index
扩展管理考核考核评分Home::Assess::add
扩展管理问卷问卷管理Home::Quests::index
扩展管理问卷填写问卷Home::Quests::add
